
NO ./texture/simple/north.xpm
SO ./texture/simple/south.xpm
WE ./texture/simple/west.xpm
EA ./texture/simple/east.xpm

111111
110001
100001
100001
100001
10N001
111111

F 192,192,192
C 102,178,255
