NO ./texture/simple/north.xpm
SO ./texture/simple/south.xpm
WE ./texture/simple/west.xpm
EA ./texture/simple/east.xpm

F 192,192,192
C 102,178,255

1111111111111111111111111111
10N0000000000000000001
10000000000000001111111
10000000000000001
10000000000000001
100011000000000011111
10000000000000001
10000000000000001
10000000000000001
100000000000000011111
10000000000111100001
10000000000000001111
1000000000000000111
10000000111000000001
11111111111111111111 
                    
				   